{
  "tiles" : [ [1, 1, 1, 1, 1, 1, 1, 1, 1 ],
              [1, 1, 1, 1, 1, 1, 1, 1, 1 ],
              [1, 1, 1, 1, 1, 1, 1, 1, 1 ],
              [1, 1, 1, 1, 1, 1, 1, 1, 1 ],
              [1, 1, 1, 1, 1, 1, 1, 1, 1 ],
              [0, 1, 1, 1, 1, 1, 1, 1, 0 ],
              [0, 0, 1, 1, 1, 1, 1, 0, 0 ],
              [0, 0, 0, 1, 1, 1, 0, 0, 0 ],
              [0, 0, 0, 0, 1, 0, 0, 0, 0 ]],

  "targetScore" : 190,
  "timeLeft" : 20,
}
